#############
#x    k    k#
##########k #
#  k     k  #
#  ##########
#    k k    #
########## k#
#    k k    #
#  ##########
#  k     k  #
##########k #
#k         k#
# ###########
#           #
#wwww   wwww#
#           #
# wwwwhwwww #
#kwww o wwwk#
#############
